....................
...GC...........X...
...--..G.......--...
....G.--........G...
...--..........--...
...G.....CG....GC...
...--....--....--...
...CG...........G...
...--.......CG.--...
...G........--.G....
...--..........--...
....G..........CG...
...--..........--...
.1..................
####################
