....................
....................
....................
....................
....................
....................
....................
....................
....................
....................
....................
....................
....................
.1........CCCCCCCCX.
####################
